#############
P.+.LR..LR###
###.C.C.C.*.X
###.LR.C..###
#############
